

NO img/wall1.xpm

SO img/wall3.xpm

WE img/wall2.xpm
EA img/wall4.xpm


F 0,50,10
C 98,30,100

11111111111111111111111111
10N0000000110000000000001
1011000001110000000000001
1001000000000000000000001
111111111011000001110000000000001
100000000011000001110111111111111
11110111111111011100000010001
11110111111111011101010010001
11000000110101011100000010001
10000000000000001100000010001
10000000000000001101010010001
1100000111010111111101111000111
11110111 1110101 101111010001
11111111 1111111 111111111111
