
1 img/doom2/ZZWOLF9.xpm
2 img/doom2/ZZWOLF2.xpm
3 img/mobile/WALL008.xpm,3 img/mobile/WALL009.xpm
4 img/mobile/WALL002.xpm,4 img/mobile/WALL003.xpm,4 img/mobile/WALL004.xpm,4 img/mobile/WALL005.xpm
5 img/doom2/ZCELL.xpm
6 img/doom2/PLAT1.xpm
: img/doom2/ZDOOR.xpm
d img/doom2/ZZWOLF10.xpm

F img/mobile/WALL013.xpm
C img/sky/sky3.xpm

11111111111111111111111111111111
10000000000000000000000000000011
10000000000000000000000000000111
10000000000000000000000000000011
10000000000000000000000000000011
10000000000000000000000000000011
10000000000001111111111111111111
1000000000000000:000000001100001
100000111111d:111111111:11100005
10000010000110000000000000000001
100000100000:0000000000000000005
10000010000110000000000000000001
1000001111111:111111111:1111:111
11111111111100011111110001100011
11111111111100011111110001100011
11111111111100011111110N01100011
11111111111111111111111111151511

img/sprite/skeleton.xpm 0 2 6 28 1
img/sprite/armor.xpm 0 30 9
img/sprite/tree.xpm 0 9 13 3 7 4 6
