

1 img/doom2/ZZWOLF1.xpm

2 img/doom2/ZZWOLF2.xpm

3 img/doom2/ZZWOLF3.xpm
4 img/doom2/ZZWOLF4.xpm


F img/mobile/WALL013.xpm
C img/sky2.xpm

11111111111111111111111111111111
10000000000000000000000000000011
10000000000000000000000000000011
10000000000000000000000000000011
10000000000000000000000000000011
10000000000000000000000000000011
10000000000001111111111111111111
10000000000000000000000000000011
10000011111110111143412211111111
10000010000110000000000000000011
10000010000000000000000000000011
10000010000110000000000000000011
1000001111111011111111101111111
11111111111100011111110001111111
11111111111100011111110N01111111
11111111111111111111111111111111
