
1 img/doom2/ZZWOLF1.xpm
2 img/doom2/ZZWOLF2.xpm
3 img/doom2/ZZWOLF3.xpm
4 img/doom2/ZZWOLF4.xpm
5 img/doom2/ZELDOOR.xpm
6 img/doom2/PLAT1.xpm
9 img/doom2/ZZWOLF10.xpm
: img/doom2/ZDOORB1.xpm

F img/mobile/WALL013.xpm
C img/sky/sky2.xpm

11111111111111111111111111111111
10000000000000000000000000000011
10000000000000000000000000000111
10000000000000000000000000000011
100S0000000000000000000000000011
10000000000000000000000000000011
10000000000001111111111111111111
1000000000000000:000000000000011
1000001111111011114341:115691111
10000010000110000000000000000011
100000100000000000000N0000000011
10000010000110000000000000000011
10000011111110111111111011111111
11111111111100011111110001111111
11111111111100011111110001111111
11111111111100011111110001111111
11111111111111111111114111111111
