

NO img/wall01.xpm

SO img/wall03.xpm

WE img/wall02.xpm
EA img/wall04.xpm


F 222, 218, 180
C 14, 22, 92


11111111111111111111111111111111
1S000000000000000000000000000011
10000000000000000000000000000011
10000000000000000000000000000011
10000000000000000000000000000011
10000000000000000000000000000011
10000000000001111111111111111111
10000000000000000000000000000011
10000011111110111111111111111111
10000010000110000000000000000011
10000010000000000000000000000011
10000010000110000000000000000011
10000011111110111111111011111111
11111111111100011111110001111111
11111111111100011111110001111111
11111111111111111111111111111111
